de=di de
uuui=wei
zhu=zhuo zhu
iiia=ya
lu=lou lu
dei=de dei
zhang=chang zhang
uuuo=wo
iiie=ye
uuun=wen
zang=cang zang
uuuai=wai
uuua=wa
zhuan=chuan zhuan
zeng=ceng zeng
riz=ri
mo=mei mo
uuueng=weng
uuuang=wang
ziy=zi
vvv=yu
iiing=ying
aaang=ang
aaa=a
hang=xing hang
eee=e
iii=yi
huan=hai huan
iiian=yan
iiiao=yao
vvvn=yun
fu=fo fu
ciy=ci
uuu=wu
iiiang=yang
vvvan=yuan
vvve=yue le
iiiong=yong
aaan=an
siy=si
eeer=er
aaao=ao
zhix=zhi
aaai=ai
uuuan=wan
eeen=en
shix=shi si
zha=za zha
ooou=ou
iiin=yin
zhe=zhuo zhe
chix=chi
iiiu=you